(neutral)
0000000000000000000000000000000000111111111111000010000000000100001000000000010000100000000001000010000000000100001010000010010000101000001001000010000000000100001010000010010000100111110001000010000000000100001111111111110000000000000000000000000000000000
(singing)
0000000000000000000000000000000000111111111111000010000000000100001000000000010000100000000001000010001001000100001011000011010000100001100001000010001001000100001000100100010000100010010001000010000110000100001111111111110000000000000000000000000000000000
(smiling)
0000000000000000000000000000000000111111111111000010000000000100001000000000010000100000000001000010000000000100001010000010010000101000001001000010011111000100001001111100010000100011100001000010000000000100001111111111110000000000000000000000000000000000
(um)
0000000000000000000000000000000000111111111111000010000000000100001000000000010000100000001001000010100001010100001001100000010000100100001001000010010000100100001000000000010000100111111001000010000000000100001111111111110000000000000000000000000000000000
(freaky)
0000000000000000000000000000000000111111111111000010000000000100001000000000010000100000000001000010100000010100001000000000010000101111111101000010101001010100001010100101010000100110011001000010001001000100001111100111110000000011110000000000000000000000
(music)
0000000000000000000010000000000000001100000000000000101000000000000010000000000000001000000000000001100000000000001111001111111000111100110001100011110010000100000110001000010000000001100011000000001111011110000000111101111000000001100011000000000000000000
(hm)
0000000000000000000000000000000000111111111111000010000000000100001000111100010000100110011001000010010000100100001000000010010000100001111001000010000110000100001000000000010000100001100001000010000000000100001111111111110000000000000000000000000000000000